000000000000111000000001110000000111000000011100000001110000000111000011
000000000000111000000001110000000111000000011100000001110000000111000011
000000000001111100000011111000001111100000111110000011111000001111100011
000000000000000000000000000000000000000000000000000000000000000000000011
000000000000000000000000000000000000000000000000000000000000000000000011
000000000001111100000011111000001111100000111110000011111000001111100011
000000000000111000000001110000000111000000011100000001110000000111000011
000000000000111000000001110000000111000000011100000001110000000111000011
